District,Original Maize Production Value,Perturbation,Factor,New Maize Production Values,Percentage Change,Change
BENGALURU,2879,10,TotalNPK,3894,35.2552969781174,1015
BENGALURU(R),42583,10,TotalNPK,49619,16.523025620552804,7036
RAMANAGARA,10450,10,TotalNPK,10965,4.92822966507177,515
CHITRADURGA,271975,10,TotalNPK,297241,9.289824432392683,25266
DAVANAGERE,593544,10,TotalNPK,653109,10.035481783995795,59565
KOLAR,1759,10,TotalNPK,2270,29.050596930073908,511
CHIKKABALLAPURA,105491,10,TotalNPK,124487,18.0072233650264,18996
SHIVAMOGGA,226532,10,TotalNPK,250699,10.668249960270513,24167
TUMAKURU,66868,10,TotalNPK,73232,9.517257881198779,6364
CHIKKAMAGALURU,61353,10,TotalNPK,76954,25.428259416817433,15601
DAKSHINA KANNADA,0,10,TotalNPK,0,,0
UDUPI,109,10,TotalNPK,113,3.669724770642202,4
HASSAN,333937,10,TotalNPK,366530,9.760224233912385,32593
KODAGU,17921,10,TotalNPK,24652,37.559287986161486,6731
MANDYA,19387,10,TotalNPK,22158,14.293082993758704,2771
MYSURU,137154,10,TotalNPK,150439,9.686192163553379,13285
CHAMARAJANAGAR,147886,10,TotalNPK,161830,9.428884410965203,13944
BELAGAVI,576758,10,TotalNPK,631048,9.412960028296096,54290
VIJAYAPURA,226327,10,TotalNPK,238042,5.176138949396228,11715
BAGALKOT,251699,10,TotalNPK,277490,10.246762998661099,25791
DHARAWAD,90634,10,TotalNPK,97883,7.998102257430986,7249
GADAG,138476,10,TotalNPK,144762,4.5394147722349,6286
HAVERI,413487,10,TotalNPK,437919,5.908771013357131,24432
UTTARA KANNADA,24088,10,TotalNPK,25241,4.786615742278313,1153
BALLARI,104045,10,TotalNPK,116579,12.046710557931664,12534
BIDAR,2791,10,TotalNPK,3162,13.292726621282695,371
KALABURAGI,14621,10,TotalNPK,15680,7.243006634293141,1059
YADGIRI,2673,10,TotalNPK,3222,20.53872053872054,549
RAICHUR,723,10,TotalNPK,814,12.586445366528354,91
KOPPAL,190252,10,TotalNPK,206654,8.621197149044425,16402
VIJAYANAGARA,104045,10,TotalNPK,116579,12.046710557931664,12534
BENGALURU,2879,10,SowingSeedsDistributed_Maize,2911,1.1114970475859673,32
BENGALURU(R),42583,10,SowingSeedsDistributed_Maize,43571,2.320174717610314,988
RAMANAGARA,10450,10,SowingSeedsDistributed_Maize,12359,18.267942583732058,1909
CHITRADURGA,271975,10,SowingSeedsDistributed_Maize,308697,13.501976284584979,36722
DAVANAGERE,593544,10,SowingSeedsDistributed_Maize,638489,7.572311404040813,44945
KOLAR,1759,10,SowingSeedsDistributed_Maize,2136,21.43263217737351,377
CHIKKABALLAPURA,105491,10,SowingSeedsDistributed_Maize,131455,24.61252618706809,25964
SHIVAMOGGA,226532,10,SowingSeedsDistributed_Maize,254521,12.355428813589251,27989
TUMAKURU,66868,10,SowingSeedsDistributed_Maize,78902,17.996650116647725,12034
CHIKKAMAGALURU,61353,10,SowingSeedsDistributed_Maize,71895,17.18253386142487,10542
DAKSHINA KANNADA,0,10,SowingSeedsDistributed_Maize,0,,0
UDUPI,109,10,SowingSeedsDistributed_Maize,109,0.0,0
HASSAN,333937,10,SowingSeedsDistributed_Maize,366120,9.637446584235947,32183
KODAGU,17921,10,SowingSeedsDistributed_Maize,18809,4.955080631661179,888
MANDYA,19387,10,SowingSeedsDistributed_Maize,22250,14.76762779181926,2863
MYSURU,137154,10,SowingSeedsDistributed_Maize,142827,4.136226431602432,5673
CHAMARAJANAGAR,147886,10,SowingSeedsDistributed_Maize,155294,5.009263892457704,7408
BELAGAVI,576758,10,SowingSeedsDistributed_Maize,627159,8.738673759184962,50401
VIJAYAPURA,226327,10,SowingSeedsDistributed_Maize,237705,5.0272393483764635,11378
BAGALKOT,251699,10,SowingSeedsDistributed_Maize,275781,9.567777384892272,24082
DHARAWAD,90634,10,SowingSeedsDistributed_Maize,101115,11.564092945252334,10481
GADAG,138476,10,SowingSeedsDistributed_Maize,155911,12.590629423149139,17435
HAVERI,413487,10,SowingSeedsDistributed_Maize,461522,11.617052047585535,48035
UTTARA KANNADA,24088,10,SowingSeedsDistributed_Maize,30319,25.86765194287612,6231
BALLARI,104045,10,SowingSeedsDistributed_Maize,114140,9.702532558027777,10095
BIDAR,2791,10,SowingSeedsDistributed_Maize,2877,3.081332855607309,86
KALABURAGI,14621,10,SowingSeedsDistributed_Maize,15203,3.9805758840024623,582
YADGIRI,2673,10,SowingSeedsDistributed_Maize,2673,0.0,0
RAICHUR,723,10,SowingSeedsDistributed_Maize,773,6.915629322268327,50
KOPPAL,190252,10,SowingSeedsDistributed_Maize,208937,9.82118453419675,18685
VIJAYANAGARA,104045,10,SowingSeedsDistributed_Maize,114140,9.702532558027777,10095
BENGALURU,2879,10,LivestockCensus_2012_Cattle,3812,32.407085793678355,933
BENGALURU(R),42583,10,LivestockCensus_2012_Cattle,51689,21.38412042364324,9106
RAMANAGARA,10450,10,LivestockCensus_2012_Cattle,13261,26.89952153110048,2811
CHITRADURGA,271975,10,LivestockCensus_2012_Cattle,302461,11.209118485154885,30486
DAVANAGERE,593544,10,LivestockCensus_2012_Cattle,624698,5.248810534686561,31154
KOLAR,1759,10,LivestockCensus_2012_Cattle,2587,47.072200113700966,828
CHIKKABALLAPURA,105491,10,LivestockCensus_2012_Cattle,131389,24.54996160809927,25898
SHIVAMOGGA,226532,10,LivestockCensus_2012_Cattle,264619,16.8130771811488,38087
TUMAKURU,66868,10,LivestockCensus_2012_Cattle,80668,20.63767422384399,13800
CHIKKAMAGALURU,61353,10,LivestockCensus_2012_Cattle,70112,14.276400502012942,8759
DAKSHINA KANNADA,0,10,LivestockCensus_2012_Cattle,0,,0
UDUPI,109,10,LivestockCensus_2012_Cattle,129,18.34862385321101,20
HASSAN,333937,10,LivestockCensus_2012_Cattle,366539,9.762919353051624,32602
KODAGU,17921,10,LivestockCensus_2012_Cattle,19561,9.151275040455332,1640
MANDYA,19387,10,LivestockCensus_2012_Cattle,21281,9.769433125290144,1894
MYSURU,137154,10,LivestockCensus_2012_Cattle,150442,9.688379485833442,13288
CHAMARAJANAGAR,147886,10,LivestockCensus_2012_Cattle,165243,11.736743167034067,17357
BELAGAVI,576758,10,LivestockCensus_2012_Cattle,638961,10.784939263954726,62203
VIJAYAPURA,226327,10,LivestockCensus_2012_Cattle,245342,8.401560573859946,19015
BAGALKOT,251699,10,LivestockCensus_2012_Cattle,281257,11.743391908589228,29558
DHARAWAD,90634,10,LivestockCensus_2012_Cattle,103706,14.422843524505153,13072
GADAG,138476,10,LivestockCensus_2012_Cattle,151875,9.676044946416708,13399
HAVERI,413487,10,LivestockCensus_2012_Cattle,450700,8.9997992681753,37213
UTTARA KANNADA,24088,10,LivestockCensus_2012_Cattle,32912,36.632348057123885,8824
BALLARI,104045,10,LivestockCensus_2012_Cattle,115602,11.107693786342448,11557
BIDAR,2791,10,LivestockCensus_2012_Cattle,3960,41.88462916517377,1169
KALABURAGI,14621,10,LivestockCensus_2012_Cattle,17687,20.969837904384107,3066
YADGIRI,2673,10,LivestockCensus_2012_Cattle,3290,23.082678638234196,617
RAICHUR,723,10,LivestockCensus_2012_Cattle,815,12.72475795297372,92
KOPPAL,190252,10,LivestockCensus_2012_Cattle,209444,10.087673191346216,19192
VIJAYANAGARA,104045,10,LivestockCensus_2012_Cattle,115602,11.107693786342448,11557
BENGALURU,2879,10,AreaUnderCereals_Maize,3252,12.955887460923933,373
BENGALURU(R),42583,10,AreaUnderCereals_Maize,47500,11.546861423572787,4917
RAMANAGARA,10450,10,AreaUnderCereals_Maize,11107,6.287081339712919,657
CHITRADURGA,271975,10,AreaUnderCereals_Maize,302468,11.211692251126022,30493
DAVANAGERE,593544,10,AreaUnderCereals_Maize,650897,9.662805116385643,57353
KOLAR,1759,10,AreaUnderCereals_Maize,1970,11.995451961341672,211
CHIKKABALLAPURA,105491,10,AreaUnderCereals_Maize,125130,18.61675403588932,19639
SHIVAMOGGA,226532,10,AreaUnderCereals_Maize,241028,6.399095933466353,14496
TUMAKURU,66868,10,AreaUnderCereals_Maize,74874,11.972842017108333,8006
CHIKKAMAGALURU,61353,10,AreaUnderCereals_Maize,71949,17.270549117402574,10596
DAKSHINA KANNADA,0,10,AreaUnderCereals_Maize,0,,0
UDUPI,109,10,AreaUnderCereals_Maize,112,2.7522935779816518,3
HASSAN,333937,10,AreaUnderCereals_Maize,366368,9.711712089406085,32431
KODAGU,17921,10,AreaUnderCereals_Maize,19335,7.890184699514537,1414
MANDYA,19387,10,AreaUnderCereals_Maize,21393,10.347139835972559,2006
MYSURU,137154,10,AreaUnderCereals_Maize,152448,11.150968983770069,15294
CHAMARAJANAGAR,147886,10,AreaUnderCereals_Maize,163708,10.698781493853375,15822
BELAGAVI,576758,10,AreaUnderCereals_Maize,613119,6.3043772258035435,36361
VIJAYAPURA,226327,10,AreaUnderCereals_Maize,237473,4.924732798119535,11146
BAGALKOT,251699,10,AreaUnderCereals_Maize,263980,4.879240680336434,12281
DHARAWAD,90634,10,AreaUnderCereals_Maize,99200,9.451199329170068,8566
GADAG,138476,10,AreaUnderCereals_Maize,147946,6.838730177070394,9470
HAVERI,413487,10,AreaUnderCereals_Maize,460808,11.444374309228584,47321
UTTARA KANNADA,24088,10,AreaUnderCereals_Maize,25356,5.264031883095317,1268
BALLARI,104045,10,AreaUnderCereals_Maize,117333,12.77139699168629,13288
BIDAR,2791,10,AreaUnderCereals_Maize,3159,13.185238265854531,368
KALABURAGI,14621,10,AreaUnderCereals_Maize,15322,4.794473702209151,701
YADGIRI,2673,10,AreaUnderCereals_Maize,2929,9.577254021698465,256
RAICHUR,723,10,AreaUnderCereals_Maize,1415,95.71230982019364,692
KOPPAL,190252,10,AreaUnderCereals_Maize,203098,6.752097218426087,12846
VIJAYANAGARA,104045,10,AreaUnderCereals_Maize,117333,12.77139699168629,13288
BENGALURU,2879,10,NetAreaIrrigatedUnderDifferentSources_TubeWells_NetIrrigatedArea,3125,8.544633553317125,246
BENGALURU(R),42583,10,NetAreaIrrigatedUnderDifferentSources_TubeWells_NetIrrigatedArea,47074,10.546462203226639,4491
RAMANAGARA,10450,10,NetAreaIrrigatedUnderDifferentSources_TubeWells_NetIrrigatedArea,11447,9.54066985645933,997
CHITRADURGA,271975,10,NetAreaIrrigatedUnderDifferentSources_TubeWells_NetIrrigatedArea,311457,14.51677543891902,39482
DAVANAGERE,593544,10,NetAreaIrrigatedUnderDifferentSources_TubeWells_NetIrrigatedArea,621940,4.784144056716941,28396
KOLAR,1759,10,NetAreaIrrigatedUnderDifferentSources_TubeWells_NetIrrigatedArea,2040,15.974985787379193,281
CHIKKABALLAPURA,105491,10,NetAreaIrrigatedUnderDifferentSources_TubeWells_NetIrrigatedArea,125944,19.388383843171457,20453
SHIVAMOGGA,226532,10,NetAreaIrrigatedUnderDifferentSources_TubeWells_NetIrrigatedArea,234902,3.694842229795349,8370
TUMAKURU,66868,10,NetAreaIrrigatedUnderDifferentSources_TubeWells_NetIrrigatedArea,81502,21.884907579111086,14634
CHIKKAMAGALURU,61353,10,NetAreaIrrigatedUnderDifferentSources_TubeWells_NetIrrigatedArea,65885,7.386761853536095,4532
DAKSHINA KANNADA,0,10,NetAreaIrrigatedUnderDifferentSources_TubeWells_NetIrrigatedArea,0,,0
UDUPI,109,10,NetAreaIrrigatedUnderDifferentSources_TubeWells_NetIrrigatedArea,109,0.0,0
HASSAN,333937,10,NetAreaIrrigatedUnderDifferentSources_TubeWells_NetIrrigatedArea,342329,2.513048868499148,8392
KODAGU,17921,10,NetAreaIrrigatedUnderDifferentSources_TubeWells_NetIrrigatedArea,17934,0.07254059483287763,13
MANDYA,19387,10,NetAreaIrrigatedUnderDifferentSources_TubeWells_NetIrrigatedArea,19939,2.847268788363336,552
MYSURU,137154,10,NetAreaIrrigatedUnderDifferentSources_TubeWells_NetIrrigatedArea,140355,2.3338728728290827,3201
CHAMARAJANAGAR,147886,10,NetAreaIrrigatedUnderDifferentSources_TubeWells_NetIrrigatedArea,167331,13.148641521171713,19445
BELAGAVI,576758,10,NetAreaIrrigatedUnderDifferentSources_TubeWells_NetIrrigatedArea,621420,7.743629043723711,44662
VIJAYAPURA,226327,10,NetAreaIrrigatedUnderDifferentSources_TubeWells_NetIrrigatedArea,252318,11.483826498826918,25991
BAGALKOT,251699,10,NetAreaIrrigatedUnderDifferentSources_TubeWells_NetIrrigatedArea,289569,15.045749089189867,37870
DHARAWAD,90634,10,NetAreaIrrigatedUnderDifferentSources_TubeWells_NetIrrigatedArea,94912,4.720082971070459,4278
GADAG,138476,10,NetAreaIrrigatedUnderDifferentSources_TubeWells_NetIrrigatedArea,150399,8.610156272567087,11923
HAVERI,413487,10,NetAreaIrrigatedUnderDifferentSources_TubeWells_NetIrrigatedArea,438591,6.071291237693083,25104
UTTARA KANNADA,24088,10,NetAreaIrrigatedUnderDifferentSources_TubeWells_NetIrrigatedArea,24763,2.8022251743606774,675
BALLARI,104045,10,NetAreaIrrigatedUnderDifferentSources_TubeWells_NetIrrigatedArea,116704,12.166850881829976,12659
BIDAR,2791,10,NetAreaIrrigatedUnderDifferentSources_TubeWells_NetIrrigatedArea,3039,8.885704048728055,248
KALABURAGI,14621,10,NetAreaIrrigatedUnderDifferentSources_TubeWells_NetIrrigatedArea,15413,5.416866151426031,792
YADGIRI,2673,10,NetAreaIrrigatedUnderDifferentSources_TubeWells_NetIrrigatedArea,2782,4.077815188926301,109
RAICHUR,723,10,NetAreaIrrigatedUnderDifferentSources_TubeWells_NetIrrigatedArea,740,2.351313969571231,17
KOPPAL,190252,10,NetAreaIrrigatedUnderDifferentSources_TubeWells_NetIrrigatedArea,205498,8.013581985997519,15246
VIJAYANAGARA,104045,10,NetAreaIrrigatedUnderDifferentSources_TubeWells_NetIrrigatedArea,116704,12.166850881829976,12659
BENGALURU,2879,-10,TotalNPK,1863,-35.29003126085446,-1016
BENGALURU(R),42583,-10,TotalNPK,35546,-16.52537397553014,-7037
RAMANAGARA,10450,-10,TotalNPK,9934,-4.937799043062201,-516
CHITRADURGA,271975,-10,TotalNPK,246708,-9.290192113245704,-25267
DAVANAGERE,593544,-10,TotalNPK,533978,-10.035650263501948,-59566
KOLAR,1759,-10,TotalNPK,1247,-29.10744741330301,-512
CHIKKABALLAPURA,105491,-10,TotalNPK,86494,-18.008171313192594,-18997
SHIVAMOGGA,226532,-10,TotalNPK,202364,-10.668691399007646,-24168
TUMAKURU,66868,-10,TotalNPK,60503,-9.518753364838188,-6365
CHIKKAMAGALURU,61353,-10,TotalNPK,45751,-25.429889328965167,-15602
DAKSHINA KANNADA,0,-10,TotalNPK,0,,0
UDUPI,109,-10,TotalNPK,104,-4.587155963302752,-5
HASSAN,333937,-10,TotalNPK,301343,-9.760523691594521,-32594
KODAGU,17921,-10,TotalNPK,11189,-37.56486803191786,-6732
MANDYA,19387,-10,TotalNPK,16615,-14.298241089389796,-2772
MYSURU,137154,-10,TotalNPK,123868,-9.686921270980067,-13286
CHAMARAJANAGAR,147886,-10,TotalNPK,133941,-9.429560607494961,-13945
BELAGAVI,576758,-10,TotalNPK,522467,-9.41313341124007,-54291
VIJAYAPURA,226327,-10,TotalNPK,214611,-5.176580787974921,-11716
BAGALKOT,251699,-10,TotalNPK,225907,-10.247160298610643,-25792
DHARAWAD,90634,-10,TotalNPK,83384,-7.999205596133901,-7250
GADAG,138476,-10,TotalNPK,132189,-4.540136919032902,-6287
HAVERI,413487,-10,TotalNPK,389054,-5.909012858929059,-24433
UTTARA KANNADA,24088,-10,TotalNPK,22934,-4.7907671869810695,-1154
BALLARI,104045,-10,TotalNPK,91510,-12.04767168052285,-12535
BIDAR,2791,-10,TotalNPK,2419,-13.328556073092082,-372
KALABURAGI,14621,-10,TotalNPK,13561,-7.249846111757062,-1060
YADGIRI,2673,-10,TotalNPK,2123,-20.5761316872428,-550
RAICHUR,723,-10,TotalNPK,631,-12.72475795297372,-92
KOPPAL,190252,-10,TotalNPK,173849,-8.62172276769758,-16403
VIJAYANAGARA,104045,-10,TotalNPK,91510,-12.04767168052285,-12535
BENGALURU,2879,-10,SowingSeedsDistributed_Maize,2846,-1.1462313303230287,-33
BENGALURU(R),42583,-10,SowingSeedsDistributed_Maize,41594,-2.3225230725876527,-989
RAMANAGARA,10450,-10,SowingSeedsDistributed_Maize,8540,-18.277511961722485,-1910
CHITRADURGA,271975,-10,SowingSeedsDistributed_Maize,235252,-13.502343965438,-36723
DAVANAGERE,593544,-10,SowingSeedsDistributed_Maize,548598,-7.572479883546965,-44946
KOLAR,1759,-10,SowingSeedsDistributed_Maize,1381,-21.489482660602615,-378
CHIKKABALLAPURA,105491,-10,SowingSeedsDistributed_Maize,79526,-24.613474135234288,-25965
SHIVAMOGGA,226532,-10,SowingSeedsDistributed_Maize,198542,-12.355870252326383,-27990
TUMAKURU,66868,-10,SowingSeedsDistributed_Maize,54833,-17.99814560028713,-12035
CHIKKAMAGALURU,61353,-10,SowingSeedsDistributed_Maize,50810,-17.184163773572607,-10543
DAKSHINA KANNADA,0,-10,SowingSeedsDistributed_Maize,0,,0
UDUPI,109,-10,SowingSeedsDistributed_Maize,109,0.0,0
HASSAN,333937,-10,SowingSeedsDistributed_Maize,301753,-9.637746041918087,-32184
KODAGU,17921,-10,SowingSeedsDistributed_Maize,17032,-4.960660677417555,-889
MANDYA,19387,-10,SowingSeedsDistributed_Maize,16523,-14.772785887450354,-2864
MYSURU,137154,-10,SowingSeedsDistributed_Maize,131480,-4.13695553902912,-5674
CHAMARAJANAGAR,147886,-10,SowingSeedsDistributed_Maize,140477,-5.009940088987463,-7409
BELAGAVI,576758,-10,SowingSeedsDistributed_Maize,526356,-8.738847142128934,-50402
VIJAYAPURA,226327,-10,SowingSeedsDistributed_Maize,214948,-5.027681186955158,-11379
BAGALKOT,251699,-10,SowingSeedsDistributed_Maize,227616,-9.568174684841816,-24083
DHARAWAD,90634,-10,SowingSeedsDistributed_Maize,80152,-11.565196283955249,-10482
GADAG,138476,-10,SowingSeedsDistributed_Maize,121040,-12.59135156994714,-17436
HAVERI,413487,-10,SowingSeedsDistributed_Maize,365451,-11.617293893157463,-48036
UTTARA KANNADA,24088,-10,SowingSeedsDistributed_Maize,17856,-25.87180338757888,-6232
BALLARI,104045,-10,SowingSeedsDistributed_Maize,93949,-9.703493680618964,-10096
BIDAR,2791,-10,SowingSeedsDistributed_Maize,2704,-3.1171623074166965,-87
KALABURAGI,14621,-10,SowingSeedsDistributed_Maize,14038,-3.9874153614663843,-583
YADGIRI,2673,-10,SowingSeedsDistributed_Maize,2673,0.0,0
RAICHUR,723,-10,SowingSeedsDistributed_Maize,672,-7.053941908713693,-51
KOPPAL,190252,-10,SowingSeedsDistributed_Maize,171566,-9.821710152849903,-18686
VIJAYANAGARA,104045,-10,SowingSeedsDistributed_Maize,93949,-9.703493680618964,-10096
BENGALURU,2879,-10,LivestockCensus_2012_Cattle,1945,-32.441820076415425,-934
BENGALURU(R),42583,-10,LivestockCensus_2012_Cattle,33476,-21.386468778620575,-9107
RAMANAGARA,10450,-10,LivestockCensus_2012_Cattle,7638,-26.90909090909091,-2812
CHITRADURGA,271975,-10,LivestockCensus_2012_Cattle,241488,-11.209486166007904,-30487
DAVANAGERE,593544,-10,LivestockCensus_2012_Cattle,562389,-5.248979014192714,-31155
KOLAR,1759,-10,LivestockCensus_2012_Cattle,930,-47.12905059693007,-829
CHIKKABALLAPURA,105491,-10,LivestockCensus_2012_Cattle,79592,-24.550909556265463,-25899
SHIVAMOGGA,226532,-10,LivestockCensus_2012_Cattle,188444,-16.81351861988593,-38088
TUMAKURU,66868,-10,LivestockCensus_2012_Cattle,53067,-20.6391697074834,-13801
CHIKKAMAGALURU,61353,-10,LivestockCensus_2012_Cattle,52593,-14.278030414160678,-8760
DAKSHINA KANNADA,0,-10,LivestockCensus_2012_Cattle,0,,0
UDUPI,109,-10,LivestockCensus_2012_Cattle,88,-19.26605504587156,-21
HASSAN,333937,-10,LivestockCensus_2012_Cattle,301334,-9.763218810733761,-32603
KODAGU,17921,-10,LivestockCensus_2012_Cattle,16280,-9.156855086211706,-1641
MANDYA,19387,-10,LivestockCensus_2012_Cattle,17492,-9.774591220921236,-1895
MYSURU,137154,-10,LivestockCensus_2012_Cattle,123865,-9.68910859326013,-13289
CHAMARAJANAGAR,147886,-10,LivestockCensus_2012_Cattle,130528,-11.737419363563827,-17358
BELAGAVI,576758,-10,LivestockCensus_2012_Cattle,514554,-10.7851126468987,-62204
VIJAYAPURA,226327,-10,LivestockCensus_2012_Cattle,207311,-8.402002412438641,-19016
BAGALKOT,251699,-10,LivestockCensus_2012_Cattle,222140,-11.74378920853877,-29559
DHARAWAD,90634,-10,LivestockCensus_2012_Cattle,77561,-14.423946863208068,-13073
GADAG,138476,-10,LivestockCensus_2012_Cattle,125076,-9.676767093214709,-13400
HAVERI,413487,-10,LivestockCensus_2012_Cattle,376273,-9.000041113747228,-37214
UTTARA KANNADA,24088,-10,LivestockCensus_2012_Cattle,15263,-36.636499501826634,-8825
BALLARI,104045,-10,LivestockCensus_2012_Cattle,92487,-11.108654908933635,-11558
BIDAR,2791,-10,LivestockCensus_2012_Cattle,1621,-41.92045861698316,-1170
KALABURAGI,14621,-10,LivestockCensus_2012_Cattle,11554,-20.976677381848027,-3067
YADGIRI,2673,-10,LivestockCensus_2012_Cattle,2055,-23.120089786756452,-618
RAICHUR,723,-10,LivestockCensus_2012_Cattle,630,-12.863070539419086,-93
KOPPAL,190252,-10,LivestockCensus_2012_Cattle,171059,-10.08819880999937,-19193
VIJAYANAGARA,104045,-10,LivestockCensus_2012_Cattle,92487,-11.108654908933635,-11558
BENGALURU,2879,-10,AreaUnderCereals_Maize,2505,-12.990621743660993,-374
BENGALURU(R),42583,-10,AreaUnderCereals_Maize,37665,-11.549209778550127,-4918
RAMANAGARA,10450,-10,AreaUnderCereals_Maize,9792,-6.296650717703349,-658
CHITRADURGA,271975,-10,AreaUnderCereals_Maize,241481,-11.212059931979041,-30494
DAVANAGERE,593544,-10,AreaUnderCereals_Maize,536190,-9.662973595891795,-57354
KOLAR,1759,-10,AreaUnderCereals_Maize,1547,-12.052302444570778,-212
CHIKKABALLAPURA,105491,-10,AreaUnderCereals_Maize,85851,-18.61770198405551,-19640
SHIVAMOGGA,226532,-10,AreaUnderCereals_Maize,212035,-6.399537372203485,-14497
TUMAKURU,66868,-10,AreaUnderCereals_Maize,58861,-11.974337500747742,-8007
CHIKKAMAGALURU,61353,-10,AreaUnderCereals_Maize,50756,-17.27217902955031,-10597
DAKSHINA KANNADA,0,-10,AreaUnderCereals_Maize,0,,0
UDUPI,109,-10,AreaUnderCereals_Maize,105,-3.669724770642202,-4
HASSAN,333937,-10,AreaUnderCereals_Maize,301505,-9.712011547088222,-32432
KODAGU,17921,-10,AreaUnderCereals_Maize,16506,-7.895764745270911,-1415
MANDYA,19387,-10,AreaUnderCereals_Maize,17380,-10.352297931603651,-2007
MYSURU,137154,-10,AreaUnderCereals_Maize,121859,-11.151698091196756,-15295
CHAMARAJANAGAR,147886,-10,AreaUnderCereals_Maize,132063,-10.699457690383133,-15823
BELAGAVI,576758,-10,AreaUnderCereals_Maize,540396,-6.304550608747517,-36362
VIJAYAPURA,226327,-10,AreaUnderCereals_Maize,215180,-4.9251746366982285,-11147
BAGALKOT,251699,-10,AreaUnderCereals_Maize,239417,-4.879637980285977,-12282
DHARAWAD,90634,-10,AreaUnderCereals_Maize,82067,-9.452302667872983,-8567
GADAG,138476,-10,AreaUnderCereals_Maize,129005,-6.839452323868396,-9471
HAVERI,413487,-10,AreaUnderCereals_Maize,366165,-11.444616154800514,-47322
UTTARA KANNADA,24088,-10,AreaUnderCereals_Maize,22819,-5.268183327798074,-1269
BALLARI,104045,-10,AreaUnderCereals_Maize,90756,-12.772358114277477,-13289
BIDAR,2791,-10,AreaUnderCereals_Maize,2422,-13.22106771766392,-369
KALABURAGI,14621,-10,AreaUnderCereals_Maize,13919,-4.801313179673073,-702
YADGIRI,2673,-10,AreaUnderCereals_Maize,2416,-9.614665170220727,-257
RAICHUR,723,-10,AreaUnderCereals_Maize,30,-95.850622406639,-693
KOPPAL,190252,-10,AreaUnderCereals_Maize,177405,-6.752622837079242,-12847
VIJAYANAGARA,104045,-10,AreaUnderCereals_Maize,90756,-12.772358114277477,-13289
BENGALURU,2879,-10,NetAreaIrrigatedUnderDifferentSources_TubeWells_NetIrrigatedArea,2632,-8.579367836054185,-247
BENGALURU(R),42583,-10,NetAreaIrrigatedUnderDifferentSources_TubeWells_NetIrrigatedArea,38091,-10.548810558203977,-4492
RAMANAGARA,10450,-10,NetAreaIrrigatedUnderDifferentSources_TubeWells_NetIrrigatedArea,9452,-9.55023923444976,-998
CHITRADURGA,271975,-10,NetAreaIrrigatedUnderDifferentSources_TubeWells_NetIrrigatedArea,232492,-14.517143119772038,-39483
DAVANAGERE,593544,-10,NetAreaIrrigatedUnderDifferentSources_TubeWells_NetIrrigatedArea,565147,-4.784312536223094,-28397
KOLAR,1759,-10,NetAreaIrrigatedUnderDifferentSources_TubeWells_NetIrrigatedArea,1477,-16.0318362706083,-282
CHIKKABALLAPURA,105491,-10,NetAreaIrrigatedUnderDifferentSources_TubeWells_NetIrrigatedArea,85037,-19.38933179133765,-20454
SHIVAMOGGA,226532,-10,NetAreaIrrigatedUnderDifferentSources_TubeWells_NetIrrigatedArea,218161,-3.6952836685324812,-8371
TUMAKURU,66868,-10,NetAreaIrrigatedUnderDifferentSources_TubeWells_NetIrrigatedArea,52233,-21.886403062750492,-14635
CHIKKAMAGALURU,61353,-10,NetAreaIrrigatedUnderDifferentSources_TubeWells_NetIrrigatedArea,56820,-7.38839176568383,-4533
DAKSHINA KANNADA,0,-10,NetAreaIrrigatedUnderDifferentSources_TubeWells_NetIrrigatedArea,0,,0
UDUPI,109,-10,NetAreaIrrigatedUnderDifferentSources_TubeWells_NetIrrigatedArea,108,-0.9174311926605505,-1
HASSAN,333937,-10,NetAreaIrrigatedUnderDifferentSources_TubeWells_NetIrrigatedArea,325544,-2.5133483261812857,-8393
KODAGU,17921,-10,NetAreaIrrigatedUnderDifferentSources_TubeWells_NetIrrigatedArea,17907,-0.07812064058925283,-14
MANDYA,19387,-10,NetAreaIrrigatedUnderDifferentSources_TubeWells_NetIrrigatedArea,18834,-2.852426883994429,-553
MYSURU,137154,-10,NetAreaIrrigatedUnderDifferentSources_TubeWells_NetIrrigatedArea,133952,-2.334601980255771,-3202
CHAMARAJANAGAR,147886,-10,NetAreaIrrigatedUnderDifferentSources_TubeWells_NetIrrigatedArea,128440,-13.149317717701473,-19446
BELAGAVI,576758,-10,NetAreaIrrigatedUnderDifferentSources_TubeWells_NetIrrigatedArea,532095,-7.743802426667684,-44663
VIJAYAPURA,226327,-10,NetAreaIrrigatedUnderDifferentSources_TubeWells_NetIrrigatedArea,200335,-11.484268337405613,-25992
BAGALKOT,251699,-10,NetAreaIrrigatedUnderDifferentSources_TubeWells_NetIrrigatedArea,213828,-15.046146389139409,-37871
DHARAWAD,90634,-10,NetAreaIrrigatedUnderDifferentSources_TubeWells_NetIrrigatedArea,86355,-4.721186309773374,-4279
GADAG,138476,-10,NetAreaIrrigatedUnderDifferentSources_TubeWells_NetIrrigatedArea,126552,-8.610878419365088,-11924
HAVERI,413487,-10,NetAreaIrrigatedUnderDifferentSources_TubeWells_NetIrrigatedArea,388382,-6.071533083265012,-25105
UTTARA KANNADA,24088,-10,NetAreaIrrigatedUnderDifferentSources_TubeWells_NetIrrigatedArea,23412,-2.806376619063434,-676
BALLARI,104045,-10,NetAreaIrrigatedUnderDifferentSources_TubeWells_NetIrrigatedArea,91385,-12.167812004421164,-12660
BIDAR,2791,-10,NetAreaIrrigatedUnderDifferentSources_TubeWells_NetIrrigatedArea,2542,-8.921533500537441,-249
KALABURAGI,14621,-10,NetAreaIrrigatedUnderDifferentSources_TubeWells_NetIrrigatedArea,13828,-5.423705628889953,-793
YADGIRI,2673,-10,NetAreaIrrigatedUnderDifferentSources_TubeWells_NetIrrigatedArea,2563,-4.11522633744856,-110
RAICHUR,723,-10,NetAreaIrrigatedUnderDifferentSources_TubeWells_NetIrrigatedArea,705,-2.4896265560165975,-18
KOPPAL,190252,-10,NetAreaIrrigatedUnderDifferentSources_TubeWells_NetIrrigatedArea,175005,-8.014107604650674,-15247
VIJAYANAGARA,104045,-10,NetAreaIrrigatedUnderDifferentSources_TubeWells_NetIrrigatedArea,91385,-12.167812004421164,-12660
BENGALURU,2879,20,TotalNPK,4909,70.5105939562348,2030
BENGALURU(R),42583,20,TotalNPK,56655,33.04605124110561,14072
RAMANAGARA,10450,20,TotalNPK,11480,9.85645933014354,1030
CHITRADURGA,271975,20,TotalNPK,322507,18.579648864785366,50532
DAVANAGERE,593544,20,TotalNPK,712675,20.07113204749774,119131
KOLAR,1759,20,TotalNPK,2782,58.158044343376915,1023
CHIKKABALLAPURA,105491,20,TotalNPK,143483,36.0144467300528,37992
SHIVAMOGGA,226532,20,TotalNPK,274866,21.336499920541026,48334
TUMAKURU,66868,20,TotalNPK,79597,19.036011246036967,12729
CHIKKAMAGALURU,61353,20,TotalNPK,92556,50.85814874578261,31203
DAKSHINA KANNADA,0,20,TotalNPK,0,,0
UDUPI,109,20,TotalNPK,117,7.339449541284404,8
HASSAN,333937,20,TotalNPK,399124,19.520747925506907,65187
KODAGU,17921,20,TotalNPK,31383,75.11857597232297,13462
MANDYA,19387,20,TotalNPK,24929,28.586165987517408,5542
MYSURU,137154,20,TotalNPK,163724,19.372384327106758,26570
CHAMARAJANAGAR,147886,20,TotalNPK,175774,18.857768821930406,27888
BELAGAVI,576758,20,TotalNPK,685339,18.826093439536166,108581
VIJAYAPURA,226327,20,TotalNPK,249757,10.352277898792456,23430
BAGALKOT,251699,20,TotalNPK,303282,20.493923297271742,51583
DHARAWAD,90634,20,TotalNPK,105132,15.996204514861972,14498
GADAG,138476,20,TotalNPK,151048,9.0788295444698,12572
HAVERI,413487,20,TotalNPK,462351,11.817542026714262,48864
UTTARA KANNADA,24088,20,TotalNPK,26394,9.573231484556626,2306
BALLARI,104045,20,TotalNPK,129113,24.09342111586333,25068
BIDAR,2791,20,TotalNPK,3534,26.621282694374777,743
KALABURAGI,14621,20,TotalNPK,16739,14.486013268586282,2118
YADGIRI,2673,20,TotalNPK,3772,41.11485222596334,1099
RAICHUR,723,20,TotalNPK,906,25.311203319502074,183
KOPPAL,190252,20,TotalNPK,223056,17.24239429808885,32804
VIJAYANAGARA,104045,20,TotalNPK,129113,24.09342111586333,25068
BENGALURU,2879,20,SowingSeedsDistributed_Maize,2944,2.2577283779089963,65
BENGALURU(R),42583,20,SowingSeedsDistributed_Maize,44560,4.642697790197967,1977
RAMANAGARA,10450,20,SowingSeedsDistributed_Maize,14268,36.535885167464116,3818
CHITRADURGA,271975,20,SowingSeedsDistributed_Maize,345419,27.003952569169957,73444
DAVANAGERE,593544,20,SowingSeedsDistributed_Maize,683435,15.144791287587777,89891
KOLAR,1759,20,SowingSeedsDistributed_Maize,2514,42.922114837976125,755
CHIKKABALLAPURA,105491,20,SowingSeedsDistributed_Maize,157420,49.226000322302376,51929
SHIVAMOGGA,226532,20,SowingSeedsDistributed_Maize,282510,24.710857627178502,55978
TUMAKURU,66868,20,SowingSeedsDistributed_Maize,90936,35.99330023329545,24068
CHIKKAMAGALURU,61353,20,SowingSeedsDistributed_Maize,82438,34.36669763499747,21085
DAKSHINA KANNADA,0,20,SowingSeedsDistributed_Maize,0,,0
UDUPI,109,20,SowingSeedsDistributed_Maize,109,0.0,0
HASSAN,333937,20,SowingSeedsDistributed_Maize,398304,19.275192626154038,64367
KODAGU,17921,20,SowingSeedsDistributed_Maize,19698,9.915741309078735,1777
MANDYA,19387,20,SowingSeedsDistributed_Maize,25113,29.53525558363852,5726
MYSURU,137154,20,SowingSeedsDistributed_Maize,148501,8.273181970631553,11347
CHAMARAJANAGAR,147886,20,SowingSeedsDistributed_Maize,162703,10.019203981445166,14817
BELAGAVI,576758,20,SowingSeedsDistributed_Maize,677561,17.477520901313895,100803
VIJAYAPURA,226327,20,SowingSeedsDistributed_Maize,249083,10.054478696752927,22756
BAGALKOT,251699,20,SowingSeedsDistributed_Maize,299864,19.13595206973409,48165
DHARAWAD,90634,20,SowingSeedsDistributed_Maize,111597,23.12928922920758,20963
GADAG,138476,20,SowingSeedsDistributed_Maize,173347,25.181980993096275,34871
HAVERI,413487,20,SowingSeedsDistributed_Maize,509557,23.23410409517107,96070
UTTARA KANNADA,24088,20,SowingSeedsDistributed_Maize,36550,51.73530388575224,12462
BALLARI,104045,20,SowingSeedsDistributed_Maize,124235,19.405065116055553,20190
BIDAR,2791,20,SowingSeedsDistributed_Maize,2964,6.198495163024006,173
KALABURAGI,14621,20,SowingSeedsDistributed_Maize,15786,7.967991245468846,1165
YADGIRI,2673,20,SowingSeedsDistributed_Maize,2673,0.0,0
RAICHUR,723,20,SowingSeedsDistributed_Maize,824,13.96957123098202,101
KOPPAL,190252,20,SowingSeedsDistributed_Maize,227623,19.642894687046653,37371
VIJAYANAGARA,104045,20,SowingSeedsDistributed_Maize,124235,19.405065116055553,20190
BENGALURU,2879,20,LivestockCensus_2012_Cattle,4746,64.84890587009379,1867
BENGALURU(R),42583,20,LivestockCensus_2012_Cattle,60795,42.76824084728648,18212
RAMANAGARA,10450,20,LivestockCensus_2012_Cattle,16072,53.79904306220096,5622
CHITRADURGA,271975,20,LivestockCensus_2012_Cattle,332947,22.41823697030977,60972
DAVANAGERE,593544,20,LivestockCensus_2012_Cattle,655852,10.497621069373121,62308
KOLAR,1759,20,LivestockCensus_2012_Cattle,3416,94.20125071063103,1657
CHIKKABALLAPURA,105491,20,LivestockCensus_2012_Cattle,157287,49.09992321619854,51796
SHIVAMOGGA,226532,20,LivestockCensus_2012_Cattle,302707,33.62659580103473,76175
TUMAKURU,66868,20,LivestockCensus_2012_Cattle,94468,41.27534844768798,27600
CHIKKAMAGALURU,61353,20,LivestockCensus_2012_Cattle,78872,28.55443091617362,17519
DAKSHINA KANNADA,0,20,LivestockCensus_2012_Cattle,0,,0
UDUPI,109,20,LivestockCensus_2012_Cattle,149,36.69724770642202,40
HASSAN,333937,20,LivestockCensus_2012_Cattle,399142,19.526138163785383,65205
KODAGU,17921,20,LivestockCensus_2012_Cattle,21202,18.308130126667038,3281
MANDYA,19387,20,LivestockCensus_2012_Cattle,23175,19.538866250580288,3788
MYSURU,137154,20,LivestockCensus_2012_Cattle,163730,19.376758971666884,26576
CHAMARAJANAGAR,147886,20,LivestockCensus_2012_Cattle,182601,23.47416253059789,34715
BELAGAVI,576758,20,LivestockCensus_2012_Cattle,701164,21.569878527909452,124406
VIJAYAPURA,226327,20,LivestockCensus_2012_Cattle,264357,16.803121147719892,38030
BAGALKOT,251699,20,LivestockCensus_2012_Cattle,310816,23.487181117127996,59117
DHARAWAD,90634,20,LivestockCensus_2012_Cattle,116778,28.845687049010305,26144
GADAG,138476,20,LivestockCensus_2012_Cattle,165275,19.352812039631416,26799
HAVERI,413487,20,LivestockCensus_2012_Cattle,487913,17.9995985363506,74426
UTTARA KANNADA,24088,20,LivestockCensus_2012_Cattle,41737,73.26884755895051,17649
BALLARI,104045,20,LivestockCensus_2012_Cattle,127159,22.215387572684897,23114
BIDAR,2791,20,LivestockCensus_2012_Cattle,5129,83.76925833034754,2338
KALABURAGI,14621,20,LivestockCensus_2012_Cattle,20754,41.946515286232135,6133
YADGIRI,2673,20,LivestockCensus_2012_Cattle,3908,46.20276842499065,1235
RAICHUR,723,20,LivestockCensus_2012_Cattle,908,25.587828492392806,185
KOPPAL,190252,20,LivestockCensus_2012_Cattle,228637,20.175872001345585,38385
VIJAYANAGARA,104045,20,LivestockCensus_2012_Cattle,127159,22.215387572684897,23114
BENGALURU,2879,20,AreaUnderCereals_Maize,3625,25.911774921847865,746
BENGALURU(R),42583,20,AreaUnderCereals_Maize,52417,23.093722847145575,9834
RAMANAGARA,10450,20,AreaUnderCereals_Maize,11764,12.574162679425838,1314
CHITRADURGA,271975,20,AreaUnderCereals_Maize,332962,22.423752183105066,60987
DAVANAGERE,593544,20,AreaUnderCereals_Maize,708250,19.325610232771286,114706
KOLAR,1759,20,AreaUnderCereals_Maize,2182,24.04775440591245,423
CHIKKABALLAPURA,105491,20,AreaUnderCereals_Maize,144769,37.23350807177864,39278
SHIVAMOGGA,226532,20,AreaUnderCereals_Maize,255524,12.798191866932706,28992
TUMAKURU,66868,20,AreaUnderCereals_Maize,82881,23.947179517856075,16013
CHIKKAMAGALURU,61353,20,AreaUnderCereals_Maize,82546,34.542728146952875,21193
DAKSHINA KANNADA,0,20,AreaUnderCereals_Maize,0,,0
UDUPI,109,20,AreaUnderCereals_Maize,115,5.5045871559633035,6
HASSAN,333937,20,AreaUnderCereals_Maize,398800,19.42372363649431,64863
KODAGU,17921,20,AreaUnderCereals_Maize,20749,15.780369399029073,2828
MANDYA,19387,20,AreaUnderCereals_Maize,23400,20.699437767576214,4013
MYSURU,137154,20,AreaUnderCereals_Maize,167743,22.302667074966827,30589
CHAMARAJANAGAR,147886,20,AreaUnderCereals_Maize,179530,21.39756298770675,31644
BELAGAVI,576758,20,AreaUnderCereals_Maize,649481,12.608927834551059,72723
VIJAYAPURA,226327,20,AreaUnderCereals_Maize,248619,9.84946559623907,22292
BAGALKOT,251699,20,AreaUnderCereals_Maize,276261,9.758481360672867,24562
DHARAWAD,90634,20,AreaUnderCereals_Maize,107766,18.902398658340136,17132
GADAG,138476,20,AreaUnderCereals_Maize,157417,13.67818250093879,18941
HAVERI,413487,20,AreaUnderCereals_Maize,508129,22.888748618457168,94642
UTTARA KANNADA,24088,20,AreaUnderCereals_Maize,26625,10.53221521089339,2537
BALLARI,104045,20,AreaUnderCereals_Maize,130622,25.54375510596377,26577
BIDAR,2791,20,AreaUnderCereals_Maize,3527,26.370476531709063,736
KALABURAGI,14621,20,AreaUnderCereals_Maize,16024,9.595786881882225,1403
YADGIRI,2673,20,AreaUnderCereals_Maize,3185,19.15450804339693,512
RAICHUR,723,20,AreaUnderCereals_Maize,2108,191.56293222683266,1385
KOPPAL,190252,20,AreaUnderCereals_Maize,215944,13.504194436852174,25692
VIJAYANAGARA,104045,20,AreaUnderCereals_Maize,130622,25.54375510596377,26577
BENGALURU,2879,20,NetAreaIrrigatedUnderDifferentSources_TubeWells_NetIrrigatedArea,3372,17.12400138937131,493
BENGALURU(R),42583,20,NetAreaIrrigatedUnderDifferentSources_TubeWells_NetIrrigatedArea,51565,21.092924406453278,8982
RAMANAGARA,10450,20,NetAreaIrrigatedUnderDifferentSources_TubeWells_NetIrrigatedArea,12444,19.08133971291866,1994
CHITRADURGA,271975,20,NetAreaIrrigatedUnderDifferentSources_TubeWells_NetIrrigatedArea,350940,29.033918558691056,78965
DAVANAGERE,593544,20,NetAreaIrrigatedUnderDifferentSources_TubeWells_NetIrrigatedArea,650336,9.568288113433882,56792
KOLAR,1759,20,NetAreaIrrigatedUnderDifferentSources_TubeWells_NetIrrigatedArea,2322,32.00682205798749,563
CHIKKABALLAPURA,105491,20,NetAreaIrrigatedUnderDifferentSources_TubeWells_NetIrrigatedArea,146398,38.7777156345091,40907
SHIVAMOGGA,226532,20,NetAreaIrrigatedUnderDifferentSources_TubeWells_NetIrrigatedArea,243273,7.39012589832783,16741
TUMAKURU,66868,20,NetAreaIrrigatedUnderDifferentSources_TubeWells_NetIrrigatedArea,96137,43.771310641861575,29269
CHIKKAMAGALURU,61353,20,NetAreaIrrigatedUnderDifferentSources_TubeWells_NetIrrigatedArea,70417,14.77352370707219,9064
DAKSHINA KANNADA,0,20,NetAreaIrrigatedUnderDifferentSources_TubeWells_NetIrrigatedArea,0,,0
UDUPI,109,20,NetAreaIrrigatedUnderDifferentSources_TubeWells_NetIrrigatedArea,109,0.0,0
HASSAN,333937,20,NetAreaIrrigatedUnderDifferentSources_TubeWells_NetIrrigatedArea,350721,5.026097736998296,16784
KODAGU,17921,20,NetAreaIrrigatedUnderDifferentSources_TubeWells_NetIrrigatedArea,17947,0.14508118966575526,26
MANDYA,19387,20,NetAreaIrrigatedUnderDifferentSources_TubeWells_NetIrrigatedArea,20491,5.694537576726672,1104
MYSURU,137154,20,NetAreaIrrigatedUnderDifferentSources_TubeWells_NetIrrigatedArea,143557,4.668474853084854,6403
CHAMARAJANAGAR,147886,20,NetAreaIrrigatedUnderDifferentSources_TubeWells_NetIrrigatedArea,186777,26.297959238873187,38891
BELAGAVI,576758,20,NetAreaIrrigatedUnderDifferentSources_TubeWells_NetIrrigatedArea,666083,15.487431470391394,89325
VIJAYAPURA,226327,20,NetAreaIrrigatedUnderDifferentSources_TubeWells_NetIrrigatedArea,278310,22.96809483623253,51983
BAGALKOT,251699,20,NetAreaIrrigatedUnderDifferentSources_TubeWells_NetIrrigatedArea,327440,30.091895478329274,75741
DHARAWAD,90634,20,NetAreaIrrigatedUnderDifferentSources_TubeWells_NetIrrigatedArea,99190,9.440165942140919,8556
GADAG,138476,20,NetAreaIrrigatedUnderDifferentSources_TubeWells_NetIrrigatedArea,162323,17.22103469193218,23847
HAVERI,413487,20,NetAreaIrrigatedUnderDifferentSources_TubeWells_NetIrrigatedArea,463695,12.142582475386167,50208
UTTARA KANNADA,24088,20,NetAreaIrrigatedUnderDifferentSources_TubeWells_NetIrrigatedArea,25438,5.604450348721355,1350
BALLARI,104045,20,NetAreaIrrigatedUnderDifferentSources_TubeWells_NetIrrigatedArea,129363,24.333701763659953,25318
BIDAR,2791,20,NetAreaIrrigatedUnderDifferentSources_TubeWells_NetIrrigatedArea,3288,17.807237549265494,497
KALABURAGI,14621,20,NetAreaIrrigatedUnderDifferentSources_TubeWells_NetIrrigatedArea,16206,10.840571780315985,1585
YADGIRI,2673,20,NetAreaIrrigatedUnderDifferentSources_TubeWells_NetIrrigatedArea,2892,8.19304152637486,219
RAICHUR,723,20,NetAreaIrrigatedUnderDifferentSources_TubeWells_NetIrrigatedArea,757,4.702627939142462,34
KOPPAL,190252,20,NetAreaIrrigatedUnderDifferentSources_TubeWells_NetIrrigatedArea,220744,16.027163971995037,30492
VIJAYANAGARA,104045,20,NetAreaIrrigatedUnderDifferentSources_TubeWells_NetIrrigatedArea,129363,24.333701763659953,25318
BENGALURU,2879,-20,TotalNPK,848,-70.54532823897186,-2031
BENGALURU(R),42583,-20,TotalNPK,28510,-33.048399596082945,-14073
RAMANAGARA,10450,-20,TotalNPK,9419,-9.866028708133971,-1031
CHITRADURGA,271975,-20,TotalNPK,221442,-18.580016545638387,-50533
DAVANAGERE,593544,-20,TotalNPK,474412,-20.071300527003896,-119132
KOLAR,1759,-20,TotalNPK,735,-58.21489482660602,-1024
CHIKKABALLAPURA,105491,-20,TotalNPK,67498,-36.015394678218996,-37993
SHIVAMOGGA,226532,-20,TotalNPK,178197,-21.336941359278157,-48335
TUMAKURU,66868,-20,TotalNPK,54138,-19.037506729676377,-12730
CHIKKAMAGALURU,61353,-20,TotalNPK,30149,-50.859778657930335,-31204
DAKSHINA KANNADA,0,-20,TotalNPK,0,,0
UDUPI,109,-20,TotalNPK,100,-8.256880733944955,-9
HASSAN,333937,-20,TotalNPK,268749,-19.521047383189043,-65188
KODAGU,17921,-20,TotalNPK,4458,-75.12415601807935,-13463
MANDYA,19387,-20,TotalNPK,13844,-28.5913240831485,-5543
MYSURU,137154,-20,TotalNPK,110583,-19.373113434533444,-26571
CHAMARAJANAGAR,147886,-20,TotalNPK,119997,-18.858445018460166,-27889
BELAGAVI,576758,-20,TotalNPK,468176,-18.82626682248014,-108582
VIJAYAPURA,226327,-20,TotalNPK,202896,-10.35271973737115,-23431
BAGALKOT,251699,-20,TotalNPK,200115,-20.494320597221286,-51584
DHARAWAD,90634,-20,TotalNPK,76135,-15.997307853564887,-14499
GADAG,138476,-20,TotalNPK,125903,-9.0795516912678,-12573
HAVERI,413487,-20,TotalNPK,364622,-11.81778387228619,-48865
UTTARA KANNADA,24088,-20,TotalNPK,21781,-9.577382929259382,-2307
BALLARI,104045,-20,TotalNPK,78976,-24.094382238454514,-25069
BIDAR,2791,-20,TotalNPK,2047,-26.657112146184165,-744
KALABURAGI,14621,-20,TotalNPK,12502,-14.492852746050202,-2119
YADGIRI,2673,-20,TotalNPK,1573,-41.1522633744856,-1100
RAICHUR,723,-20,TotalNPK,539,-25.44951590594744,-184
KOPPAL,190252,-20,TotalNPK,157447,-17.242919916742004,-32805
VIJAYANAGARA,104045,-20,TotalNPK,78976,-24.094382238454514,-25069
BENGALURU,2879,-20,SowingSeedsDistributed_Maize,2813,-2.2924626606460574,-66
BENGALURU(R),42583,-20,SowingSeedsDistributed_Maize,40605,-4.645046145175305,-1978
RAMANAGARA,10450,-20,SowingSeedsDistributed_Maize,6631,-36.54545454545455,-3819
CHITRADURGA,271975,-20,SowingSeedsDistributed_Maize,198530,-27.004320250022978,-73445
DAVANAGERE,593544,-20,SowingSeedsDistributed_Maize,503652,-15.14495976709393,-89892
KOLAR,1759,-20,SowingSeedsDistributed_Maize,1003,-42.97896532120523,-756
CHIKKABALLAPURA,105491,-20,SowingSeedsDistributed_Maize,53561,-49.226948270468576,-51930
SHIVAMOGGA,226532,-20,SowingSeedsDistributed_Maize,170553,-24.711299065915632,-55979
TUMAKURU,66868,-20,SowingSeedsDistributed_Maize,42799,-35.99479571693486,-24069
CHIKKAMAGALURU,61353,-20,SowingSeedsDistributed_Maize,40267,-34.36832754714521,-21086
DAKSHINA KANNADA,0,-20,SowingSeedsDistributed_Maize,0,,0
UDUPI,109,-20,SowingSeedsDistributed_Maize,109,0.0,0
HASSAN,333937,-20,SowingSeedsDistributed_Maize,269569,-19.275492083836173,-64368
KODAGU,17921,-20,SowingSeedsDistributed_Maize,16143,-9.92132135483511,-1778
MANDYA,19387,-20,SowingSeedsDistributed_Maize,13660,-29.540413679269612,-5727
MYSURU,137154,-20,SowingSeedsDistributed_Maize,125806,-8.27391107805824,-11348
CHAMARAJANAGAR,147886,-20,SowingSeedsDistributed_Maize,133068,-10.019880177974926,-14818
BELAGAVI,576758,-20,SowingSeedsDistributed_Maize,475954,-17.47769428425787,-100804
VIJAYAPURA,226327,-20,SowingSeedsDistributed_Maize,203570,-10.054920535331622,-22757
BAGALKOT,251699,-20,SowingSeedsDistributed_Maize,203533,-19.136349369683632,-48166
DHARAWAD,90634,-20,SowingSeedsDistributed_Maize,69670,-23.130392567910498,-20964
GADAG,138476,-20,SowingSeedsDistributed_Maize,103604,-25.18270313989428,-34872
HAVERI,413487,-20,SowingSeedsDistributed_Maize,317416,-23.234345940742998,-96071
UTTARA KANNADA,24088,-20,SowingSeedsDistributed_Maize,11625,-51.739455330454994,-12463
BALLARI,104045,-20,SowingSeedsDistributed_Maize,83854,-19.40602623864674,-20191
BIDAR,2791,-20,SowingSeedsDistributed_Maize,2617,-6.234324614833393,-174
KALABURAGI,14621,-20,SowingSeedsDistributed_Maize,13455,-7.974830722932769,-1166
YADGIRI,2673,-20,SowingSeedsDistributed_Maize,2673,0.0,0
RAICHUR,723,-20,SowingSeedsDistributed_Maize,621,-14.107883817427386,-102
KOPPAL,190252,-20,SowingSeedsDistributed_Maize,152880,-19.643420305699806,-37372
VIJAYANAGARA,104045,-20,SowingSeedsDistributed_Maize,83854,-19.40602623864674,-20191
BENGALURU,2879,-20,LivestockCensus_2012_Cattle,1011,-64.88364015283085,-1868
BENGALURU(R),42583,-20,LivestockCensus_2012_Cattle,24370,-42.770589202263814,-18213
RAMANAGARA,10450,-20,LivestockCensus_2012_Cattle,4827,-53.80861244019138,-5623
CHITRADURGA,271975,-20,LivestockCensus_2012_Cattle,211002,-22.41860465116279,-60973
DAVANAGERE,593544,-20,LivestockCensus_2012_Cattle,531235,-10.497789548879274,-62309
KOLAR,1759,-20,LivestockCensus_2012_Cattle,101,-94.25810119386014,-1658
CHIKKABALLAPURA,105491,-20,LivestockCensus_2012_Cattle,53694,-49.10087116436473,-51797
SHIVAMOGGA,226532,-20,LivestockCensus_2012_Cattle,150356,-33.62703723977186,-76176
TUMAKURU,66868,-20,LivestockCensus_2012_Cattle,39267,-41.27684393132739,-27601
CHIKKAMAGALURU,61353,-20,LivestockCensus_2012_Cattle,43833,-28.556060828321357,-17520
DAKSHINA KANNADA,0,-20,LivestockCensus_2012_Cattle,0,,0
UDUPI,109,-20,LivestockCensus_2012_Cattle,68,-37.61467889908257,-41
HASSAN,333937,-20,LivestockCensus_2012_Cattle,268731,-19.526437621467522,-65206
KODAGU,17921,-20,LivestockCensus_2012_Cattle,14639,-18.313710172423413,-3282
MANDYA,19387,-20,LivestockCensus_2012_Cattle,15598,-19.544024346211376,-3789
MYSURU,137154,-20,LivestockCensus_2012_Cattle,110577,-19.377488079093574,-26577
CHAMARAJANAGAR,147886,-20,LivestockCensus_2012_Cattle,113170,-23.474838727127654,-34716
BELAGAVI,576758,-20,LivestockCensus_2012_Cattle,452351,-21.570051910853426,-124407
VIJAYAPURA,226327,-20,LivestockCensus_2012_Cattle,188296,-16.803562986298587,-38031
BAGALKOT,251699,-20,LivestockCensus_2012_Cattle,192581,-23.48757841707754,-59118
DHARAWAD,90634,-20,LivestockCensus_2012_Cattle,64489,-28.846790387713224,-26145
GADAG,138476,-20,LivestockCensus_2012_Cattle,111676,-19.353534186429417,-26800
HAVERI,413487,-20,LivestockCensus_2012_Cattle,339060,-17.999840381922528,-74427
UTTARA KANNADA,24088,-20,LivestockCensus_2012_Cattle,6438,-73.27299900365327,-17650
BALLARI,104045,-20,LivestockCensus_2012_Cattle,80930,-22.216348695276082,-23115
BIDAR,2791,-20,LivestockCensus_2012_Cattle,452,-83.80508778215693,-2339
KALABURAGI,14621,-20,LivestockCensus_2012_Cattle,8487,-41.953354763696055,-6134
YADGIRI,2673,-20,LivestockCensus_2012_Cattle,1437,-46.240179573512904,-1236
RAICHUR,723,-20,LivestockCensus_2012_Cattle,537,-25.72614107883817,-186
KOPPAL,190252,-20,LivestockCensus_2012_Cattle,151866,-20.17639761999874,-38386
VIJAYANAGARA,104045,-20,LivestockCensus_2012_Cattle,80930,-22.216348695276082,-23115
BENGALURU,2879,-20,AreaUnderCereals_Maize,2132,-25.946509204584927,-747
BENGALURU(R),42583,-20,AreaUnderCereals_Maize,32748,-23.096071202122914,-9835
RAMANAGARA,10450,-20,AreaUnderCereals_Maize,9135,-12.583732057416269,-1315
CHITRADURGA,271975,-20,AreaUnderCereals_Maize,210987,-22.424119863958083,-60988
DAVANAGERE,593544,-20,AreaUnderCereals_Maize,478837,-19.32577871227744,-114707
KOLAR,1759,-20,AreaUnderCereals_Maize,1335,-24.104604889141555,-424
CHIKKABALLAPURA,105491,-20,AreaUnderCereals_Maize,66212,-37.23445601994483,-39279
SHIVAMOGGA,226532,-20,AreaUnderCereals_Maize,197539,-12.79863330566984,-28993
TUMAKURU,66868,-20,AreaUnderCereals_Maize,50854,-23.948675001495484,-16014
CHIKKAMAGALURU,61353,-20,AreaUnderCereals_Maize,40159,-34.54435805910062,-21194
DAKSHINA KANNADA,0,-20,AreaUnderCereals_Maize,0,,0
UDUPI,109,-20,AreaUnderCereals_Maize,102,-6.422018348623854,-7
HASSAN,333937,-20,AreaUnderCereals_Maize,269073,-19.424023094176444,-64864
KODAGU,17921,-20,AreaUnderCereals_Maize,15092,-15.785949444785446,-2829
MANDYA,19387,-20,AreaUnderCereals_Maize,15373,-20.704595863207302,-4014
MYSURU,137154,-20,AreaUnderCereals_Maize,106564,-22.303396182393513,-30590
CHAMARAJANAGAR,147886,-20,AreaUnderCereals_Maize,116241,-21.398239184236505,-31645
BELAGAVI,576758,-20,AreaUnderCereals_Maize,504034,-12.609101217495034,-72724
VIJAYAPURA,226327,-20,AreaUnderCereals_Maize,204034,-9.849907434817764,-22293
BAGALKOT,251699,-20,AreaUnderCereals_Maize,227136,-9.75887866062241,-24563
DHARAWAD,90634,-20,AreaUnderCereals_Maize,73501,-18.90350199704305,-17133
GADAG,138476,-20,AreaUnderCereals_Maize,119534,-13.678904647736791,-18942
HAVERI,413487,-20,AreaUnderCereals_Maize,318844,-22.8889904640291,-94643
UTTARA KANNADA,24088,-20,AreaUnderCereals_Maize,21550,-10.536366655596147,-2538
BALLARI,104045,-20,AreaUnderCereals_Maize,77467,-25.544716228554954,-26578
BIDAR,2791,-20,AreaUnderCereals_Maize,2054,-26.40630598351845,-737
KALABURAGI,14621,-20,AreaUnderCereals_Maize,13217,-9.602626359346147,-1404
YADGIRI,2673,-20,AreaUnderCereals_Maize,2160,-19.19191919191919,-513
RAICHUR,723,-20,AreaUnderCereals_Maize,-662,-191.56293222683266,-1385
KOPPAL,190252,-20,AreaUnderCereals_Maize,164559,-13.504720055505329,-25693
VIJAYANAGARA,104045,-20,AreaUnderCereals_Maize,77467,-25.544716228554954,-26578
BENGALURU,2879,-20,NetAreaIrrigatedUnderDifferentSources_TubeWells_NetIrrigatedArea,2385,-17.15873567210837,-494
BENGALURU(R),42583,-20,NetAreaIrrigatedUnderDifferentSources_TubeWells_NetIrrigatedArea,33600,-21.095272761430618,-8983
RAMANAGARA,10450,-20,NetAreaIrrigatedUnderDifferentSources_TubeWells_NetIrrigatedArea,8455,-19.090909090909093,-1995
CHITRADURGA,271975,-20,NetAreaIrrigatedUnderDifferentSources_TubeWells_NetIrrigatedArea,193009,-29.034286239544077,-78966
DAVANAGERE,593544,-20,NetAreaIrrigatedUnderDifferentSources_TubeWells_NetIrrigatedArea,536751,-9.568456592940034,-56793
KOLAR,1759,-20,NetAreaIrrigatedUnderDifferentSources_TubeWells_NetIrrigatedArea,1195,-32.0636725412166,-564
CHIKKABALLAPURA,105491,-20,NetAreaIrrigatedUnderDifferentSources_TubeWells_NetIrrigatedArea,64583,-38.7786635826753,-40908
SHIVAMOGGA,226532,-20,NetAreaIrrigatedUnderDifferentSources_TubeWells_NetIrrigatedArea,209790,-7.3905673370649625,-16742
TUMAKURU,66868,-20,NetAreaIrrigatedUnderDifferentSources_TubeWells_NetIrrigatedArea,37598,-43.772806125500985,-29270
CHIKKAMAGALURU,61353,-20,NetAreaIrrigatedUnderDifferentSources_TubeWells_NetIrrigatedArea,52288,-14.775153619219925,-9065
DAKSHINA KANNADA,0,-20,NetAreaIrrigatedUnderDifferentSources_TubeWells_NetIrrigatedArea,0,,0
UDUPI,109,-20,NetAreaIrrigatedUnderDifferentSources_TubeWells_NetIrrigatedArea,108,-0.9174311926605505,-1
HASSAN,333937,-20,NetAreaIrrigatedUnderDifferentSources_TubeWells_NetIrrigatedArea,317152,-5.026397194680434,-16785
KODAGU,17921,-20,NetAreaIrrigatedUnderDifferentSources_TubeWells_NetIrrigatedArea,17894,-0.15066123542213047,-27
MANDYA,19387,-20,NetAreaIrrigatedUnderDifferentSources_TubeWells_NetIrrigatedArea,18282,-5.699695672357766,-1105
MYSURU,137154,-20,NetAreaIrrigatedUnderDifferentSources_TubeWells_NetIrrigatedArea,130750,-4.669203960511542,-6404
CHAMARAJANAGAR,147886,-20,NetAreaIrrigatedUnderDifferentSources_TubeWells_NetIrrigatedArea,108994,-26.298635435402947,-38892
BELAGAVI,576758,-20,NetAreaIrrigatedUnderDifferentSources_TubeWells_NetIrrigatedArea,487432,-15.487604853335368,-89326
VIJAYAPURA,226327,-20,NetAreaIrrigatedUnderDifferentSources_TubeWells_NetIrrigatedArea,174343,-22.968536674811226,-51984
BAGALKOT,251699,-20,NetAreaIrrigatedUnderDifferentSources_TubeWells_NetIrrigatedArea,175957,-30.092292778278818,-75742
DHARAWAD,90634,-20,NetAreaIrrigatedUnderDifferentSources_TubeWells_NetIrrigatedArea,82077,-9.441269280843834,-8557
GADAG,138476,-20,NetAreaIrrigatedUnderDifferentSources_TubeWells_NetIrrigatedArea,114628,-17.221756838730176,-23848
HAVERI,413487,-20,NetAreaIrrigatedUnderDifferentSources_TubeWells_NetIrrigatedArea,363278,-12.142824320958095,-50209
UTTARA KANNADA,24088,-20,NetAreaIrrigatedUnderDifferentSources_TubeWells_NetIrrigatedArea,22737,-5.6086017934241115,-1351
BALLARI,104045,-20,NetAreaIrrigatedUnderDifferentSources_TubeWells_NetIrrigatedArea,78726,-24.33466288625114,-25319
BIDAR,2791,-20,NetAreaIrrigatedUnderDifferentSources_TubeWells_NetIrrigatedArea,2293,-17.843067001074882,-498
KALABURAGI,14621,-20,NetAreaIrrigatedUnderDifferentSources_TubeWells_NetIrrigatedArea,13035,-10.847411257779905,-1586
YADGIRI,2673,-20,NetAreaIrrigatedUnderDifferentSources_TubeWells_NetIrrigatedArea,2453,-8.23045267489712,-220
RAICHUR,723,-20,NetAreaIrrigatedUnderDifferentSources_TubeWells_NetIrrigatedArea,688,-4.840940525587829,-35
KOPPAL,190252,-20,NetAreaIrrigatedUnderDifferentSources_TubeWells_NetIrrigatedArea,159759,-16.02768959064819,-30493
VIJAYANAGARA,104045,-20,NetAreaIrrigatedUnderDifferentSources_TubeWells_NetIrrigatedArea,78726,-24.33466288625114,-25319
